Barack_Obama	True
United_States_presidential_election,_2008	False
United_States_presidential_election,_2012	False
USSenIL	False
US_Presidents	False
050111_Osama_Bin_Laden_Death_Statement_audioonly.ogg	False
1961	False
2003_invasion_of_Iraq	False
2004_Democratic_National_Convention	False
2004_Democratic_National_Convention_keynote_address	False
2005_ALCS	False
2008_Democratic_National_Convention	False
2008_Green_National_Convention	False
2008_Libertarian_National_Convention	False
2008_Republican_National_Convention	False
2008_third_party_presidential_candidates	False
2009_G-20_Pittsburgh_summit	False
2009_Major_League_Baseball_All-Star_Game	False
2009_Nobel_Peace_Prize	False
2010_G-20_Toronto_summit	False
2010_State_of_the_Union_Address	False
2010_United_States_federal_budget	False
2011_State_of_the_Union_Address	False
2011_military_intervention_in_Libya	False
2012_Democratic_National_Convention	False
2012_Libertarian_National_Convention	False
2012_Republican_National_Convention	False
89th_Infantry_Division_(United_States)	False
ABC_News	False
A_More_Perfect_Union_(speech)	False
A_New_Beginning	False
Abbottabad	False
Abraham_Lincoln	False
Adlai_Stevenson_III	True
African-American_Civil_Rights_Movement_(1955–1968)	False
African_American	False
Air_and_Simple_Gifts	False
Al_Arabiya	False
Al_Gore	True
Al_Jazeera	False
Alan_J._Dixon	True
Alan_Keyes	True
Alan_Keyes_presidential_campaign,_2008	False
Albert_J._Hopkins	False
Alejandro_Mendoza	False
Alexi_Giannoulias	True
Alice_Palmer_(politician)	True
Alma_mater	False
Altgeld_Gardens,_Chicago	False
Alyson_Kennedy	True
Amber_Lee_Ettinger	True
America's_Independent_Party	False
American_Civil_War	False
American_Party_(1969)	False
American_Recovery_and_Reinvestment_Act_of_2009	False
Americans_Elect	False
Ames_Straw_Poll	False
Andrew_Jackson	False
Andrew_Johnson	False
Andy_Martin	True
Ann_Dunham	False
Anthropology	False
Apartheid	False
Arab-Israeli_conflict	False
Arab_League	False
Ares_I	False
Ares_V	False
Artists_for_Obama	False
Associate_Justice_of_the_United_States	False
Associate_attorney	False
Associated_Press	False
Audiobook	False
August_4	False
Author	False
Authority_control	False
Automotive_industry_crisis_of_2008–2010	False
BP	False
Bachelor_of_Arts	False
Ballot_access_for_the_2008_United_States_presidential_election	False
Barack	False
Barack_Obama,_Sr.	False
Barack_Obama_"Hope"_poster	False
Barack_Obama_"Joker"_poster	False
Barack_Obama_Supreme_Court_candidates	False
Barack_Obama_Tucson_memorial_speech	False
Barack_Obama_assassination_scare_in_Denver	False
Barack_Obama_assassination_scare_in_Tennessee	False
Barack_Obama_assassination_threats	False
Barack_Obama_citizenship_conspiracy_theories	False
Barack_Obama_economic_policy	False
Barack_Obama_election_victory_speech,_2008	False
Barack_Obama_foreign_policy	False
Barack_Obama_in_comics	False
Barack_Obama_presidential_campaign,_2008	False
Barack_Obama_presidential_campaign,_2012	False
Barack_Obama_presidential_eligibility_litigation	False
Barack_Obama_presidential_primary_campaign,_2008	False
Barack_Obama_religion_conspiracy_theories	False
Barack_Obama_social_policy	False
Barack_Obama_space_policy_speech_at_Kennedy_Space_Center	False
Barack_Obama_speech_to_joint_session_of_Congress,_February_2009	False
Barack_Obama_speech_to_joint_session_of_Congress,_September_2009	False
Barack_Obama_speech_to_joint_session_of_Congress,_September_2011	False
Barack_Obama_–_Der_schwarze_Kennedy	False
Barack_and_Michelle	False
Barack_the_Magic_Negro	False
Barak_(disambiguation)	False
Bay_Windows	False
Ben_Bernanke	True
Benjamin_Harrison	False
Benjamin_Netanyahu	True
Bernie_Mac	False
Bill_Ayers_presidential_election_controversy	False
Bill_Clinton	True
Bill_Richardson	True
Bill_Richardson_presidential_campaign,_2008	False
Bill_Still	True
Biographical_Directory_of_the_United_States_Congress	False
Black_church	False
Black_liberation_theology	False
Bloomberg_L.P.	False
Bo_(dog)	False
Bob_Barr	True
Bob_Barr_presidential_campaign,_2008	False
Bobby_Rush	True
Books_about_Barack_Obama	False
Books_by_Barack_Obama	False
Boston_Tea_Party_(political_party)	False
Bradford_Lyttle	True
Brian_Moore_(politician)	True
Brian_Moore_presidential_campaign,_2008	False
Brian_Rohrbough	True
Buddy_Roemer	True
Buddy_Roemer_presidential_campaign,_2012	False
Budget_Control_Act_of_2011	False
Bush_tax_cuts	False
Business_International_Corporation	False
C-SPAN	False
Cairo_University	False
Calvin_Coolidge	False
Camp_David	False
Campaign_finance_in_the_United_States	False
Cannabis_(drug)	False
Capital_punishment_in_the_United_States	False
Car_Allowance_Rebate_System	False
Carol_Moseley_Braun	True
Catastrophe_(book)	False
Caucus	False
Center_for_Responsive_Politics	False
Change_Is_Now:_Renewing_America's_Promise	False
Charles_B._Farwell	False
Charles_H._Percy	False
Charles_Jay	True
Charles_S._Deneen	False
Charles_W._Brooks	False
Charlie_Rose_(talk_show)	False
Chester_A._Arthur	False
Chicago	False
Chicago_Annenberg_Challenge	False
Chicago_Bears	False
Chicago_Lawn,_Chicago	False
Chicago_Sun-Times	False
Chicago_Tribune	False
Chicago_White_Sox	False
Chris_Dodd	True
Chris_Dodd_presidential_campaign,_2008	False
Christian	False
Christianity	False
Christianity_Today	False
Chrysler	False
Chrysler_Chapter_11_reorganization	False
Chuck_Baldwin	True
Chuck_Baldwin_presidential_campaign,_2008	False
Citizen's_Briefing_Book	False
Civil_Forum_on_the_Presidency	False
Civil_and_political_rights	False
Class_Action_Fairness_Act_of_2005	False
Classes_of_United_States_Senators	False
Cocaine	False
Colorado	False
Columbia_University	False
Commission_on_Presidential_Debates	False
Community_organizing	False
Comparison_of_United_States_presidential_candidates,_2008	False
Condoleezza_Rice	True
Confirmations_of_Barack_Obama's_Cabinet	False
Congressional_Black_Caucus	False
Congressional_Budget_Office	False
Congressional_Quarterly	False
Congressional_endorsements_for_the_2008_United_States_presidential_election	False
Conservative_Political_Action_Conference	False
Constellation_program	False
Constitution_Party_(United_States)	False
Constitution_Party_National_Convention	False
Constitutional_law	False
Counter-terrorism	False
Craig_Robinson_(basketball)	True
Crown_Publishing_Group	False
Culture_of_Corruption:_Obama_and_His_Team_of_Tax_Cheats,_Crooks,_and_Cronies	False
Cynthia_McKinney	True
Cynthia_McKinney_presidential_campaign,_2008	False
Daniel_Imperato	True
Darcy_Richardson	True
Darrell_Castle	True
David_Axelrod	True
David_D._McKiernan	True
David_Davis_(Supreme_Court_justice)	False
David_J._Baker	False
David_Mendell	True
David_Petraeus	True
David_Souter	True
Daytime_Emmy_Award	False
Deadheads_for_Obama	False
Death_of_Osama_bin_Laden	False
Debt_ceiling	False
Deceptive_Practices_and_Voter_Intimidation_Prevention_Act	False
Deepwater_Horizon_oil_spill	False
Default_(finance)	False
Defense_Secretary	False
Delaware	False
Delegate	False
Democratic_National_Convention	False
Democratic_Party_(Italy)	False
Democratic_Party_(United_States)	False
Democratic_Party_(United_States)_presidential_candidates,_2008	False
Democratic_Party_(United_States)_presidential_debates,_2008	False
Democratic_Party_(United_States)_presidential_primaries,_2008	False
Democratic_Party_(United_States)_vice_presidential_candidates,_2008	False
Democratic_Party_presidential_candidates,_2012	False
Democratic_Republic_of_the_Congo	False
Dennis_Kucinich	True
Dennis_Kucinich_presidential_campaign,_2008	False
Denver	False
Developing_Communities_Project	False
Diane_Beall_Templin	True
Dick_Cheney	True
Dick_Durbin	True
Disability	False
Disinvestment_from_Iran	False
Disinvestment_from_South_Africa	False
Dmitry_Medvedev	True
Dodd–Frank_Wall_Street_Reform_and_Consumer_Protection_Act	False
Don't_Ask,_Don't_Tell_Repeal_Act_of_2010	False
Don't_ask,_don't_tell	False
Donald_Trump	True
Doug_Stanhope	True
Draft_(politics)	False
Draft_Bloomberg_movement	False
Draft_Condi_movement	False
Draft_Mark_Warner_movement	False
Dreams_from_My_Father	False
Drilling_rig	False
Duncan_Hunter	True
Duncan_Hunter_presidential_campaign,_2008	False
Dwight_D._Eisenhower	False
Earl_Dodge	False
Early_life_and_career_of_Barack_Obama	False
Earmark_(politics)	False
East_Jerusalem	False
Easter_Bunny	False
Editnotices/Page/Barack_Obama	False
Ehud_Barak	True
Elaine_Brown	True
Election	False
Electoral_College_(United_States)	False
Electoral_history_of_Barack_Obama	False
Elena_Kagan	True
Elias_Kane	False
Embryonic_stem_cell	False
En-Barack_Obama-article1.ogg	False
En-us-Barack-Hussein-Obama.ogg	False
Encyclopædia_Britannica	False
Energy_policy_of_the_Obama_administration	False
Energy_policy_of_the_United_States	False
Eric_Chester	True
Estate_tax_in_the_United_States	False
Eugene_Puryear	True
Evan_Bayh	True
Evan_Bayh_presidential_campaign,_2008	False
Evan_Thomas	True
Everett_Dirksen	False
Family_of_Barack_Obama	False
Featured_articles	False
Federal_Election_Commission	False
Federal_Funding_Accountability_and_Transparency_Act_of_2006	False
Federal_Insurance_Contributions_Act_tax	False
Federal_News_Radio	False
Federal_Reserve_System	False
Federal_government_of_the_United_States	False
Fiat	False
First_100_days_of_Barack_Obama's_presidency	False
Foreign_Intelligence_Surveillance_Act_of_1978_Amendments_Act_of_2008	False
Foreign_policy_of_the_Barack_Obama_administration	False
France_24	False
Frank_McEnulty	True
Frank_Moore_(performance_artist)	True
Franklin_D._Roosevelt	False
Franklin_Pierce	False
Fred_Karger	True
Fred_Thompson	True
Fred_Thompson_presidential_campaign,_2008	False
Freedom_of_Information_Act_(United_States)	False
Fundraising_for_the_2008_United_States_presidential_election	False
Fundraising_for_the_2012_United_States_presidential_election	False
Gamaliel_Foundation	False
Game_Change	False
Gary_Johnson	True
Gary_Johnson_presidential_campaign,_2012	False
Gender	False
Gender_identity	False
Gene_Amondson	False
General_Motors	False
General_Motors_Chapter_11_reorganization	False
George_Allen_(U.S._politician)	True
George_H._W._Bush	True
George_W._Bush	True
George_Washington	False
Gerald_Ford	False
Global_warming	False
Gloria_LaRiva	False
Gloria_La_Riva	True
GovTrack	False
Grammy_Award	False
Grammy_Award_for_Best_Spoken_Word_Album	False
Grant_Park_(Chicago)	False
Green_Party_(United_States)	False
Gross_domestic_product	False
Grover_Cleveland	False
Guantanamo_Bay_detention_camp	False
Gulf_of_Mexico	False
Harold_Ford,_Jr.	True
HarperCollins	False
Harris_Interactive	False
Harry_S._Truman	False
Hartford_Courant	False
Harvard_Law_Review	False
Harvard_Law_School	False
Harvard_University	False
Hate_crimes_in_the_United_States	False
Hawaii	False
Health_Care_and_Education_Reconciliation_Act_of_2010	False
Health_care	False
Health_care_in_the_United_States	False
Health_care_reform_in_the_United_States	False
Henry_Louis_Gates_arrest_controversy	False
Herbert_Hoover	False
Herman_Cain	True
Herman_Cain_presidential_campaign,_2012	False
Hillary_Clinton_presidential_campaign,_2008	False
Hillary_Rodham_Clinton	True
Hispanic	False
Honest_Leadership_and_Open_Government_Act	False
Honolulu	False
Honolulu,_Hawaii	False
Hope!_–_Das_Obama_Musical	False
Hopkins_&_Sutter	False
Hu_Jintao	True
Human_spaceflight	False
Hyde_Park,_Chicago	False
IPA_for_English	False
I_Got_a_Crush..._on_Obama	False
Illinois	False
Illinois's_1st_congressional_district_election,_2000	False
Illinois_Secretary_of_State	False
Illinois_Senate	False
Illinois_Senate_career_of_Barack_Obama	False
Illinois_Senate_elections_of_Barack_Obama	False
Images_of_Barack_Obama	False
Inauguration_of_Barack_Obama	False
Incumbent	False
Independent_(politician)	False
India	False
Indiana_Governor	False
Indonesia	False
Indonesian_language	False
Innovation_economics	False
International_Herald_Tribune	False
International_Space_Station	False
International_Standard_Book_Number	False
International_Standard_Serial_Number	False
International_media_reaction_to_Barack_Obama's_2008_election	False
International_opinion_polling_for_the_United_States_presidential_election,_2008	False
International_reaction_to_the_United_States_presidential_election,_2008	False
International_relations	False
Internet_Movie_Database	False
Invesco_Field_at_Mile_High	False
Invitations_to_the_inauguration_of_Barack_Obama	False
Iranian_presidential_election,_2009	False
Iraq_Resolution	False
Iraq_War	False
Iraq_War_De-Escalation_Act_of_2007	False
Islamabad	False
Ivy_League	False
J._Hamilton_Lewis	False
Jack_Fellure	True
Jack_Ryan_(politician)	True
Jakarta	False
James_A._Garfield	False
James_Buchanan	False
James_Harris_(politician)	True
James_Hedges	True
James_K._Polk	False
James_M._Slattery	False
James_Madison	False
James_Monroe	False
James_Semple	False
James_Shields	False
Jeanne_Shaheen	True
Jefferson_Davis	False
Jeremiah_Wright	True
Jeremiah_Wright_controversy	False
Jesse_B._Thomas	False
Jesse_Johnson_(politician)	True
Jesse_Ventura	True
Jesse_White_(politician)	True
Jill_Stein	True
Jim_Gilmore	True
Jim_Gilmore_presidential_campaign,_2008	False
Jimmy_Carter	True
Jimmy_McMillan	True
Joe_Biden	True
Joe_Biden_presidential_campaign,_2008	False
Joe_Schriner	True
John_A._Logan	False
John_Adams	False
John_Edwards	True
John_Edwards_presidential_campaign,_2008	False
John_F._Kennedy	False
John_H._Cox	True
John_Kerry	True
John_M._Palmer_(politician)	False
John_McCain	True
John_McCain_presidential_campaign,_2008	False
John_McCracken_Robinson	False
John_McLean_(Illinois_politician)	False
John_Paul_Stevens	True
John_Quincy_Adams	False
John_Tyler	False
Joint_Political_Military_Group	False
Jon_Huntsman,_Jr.	True
Jon_Huntsman_presidential_campaign,_2012	False
Jonathon_Sharkey	True
Joseph_M._McCormick	False
Joyce_Foundation	False
Juris_Doctor	False
Kapiolani_Medical_Center_for_Women_and_Children	False
Kat_Swift	True
Ken_Salazar	True
Kent_Mesplay	True
Kenwood,_Chicago	False
Kenya_Colony	False
Keynote	False
Kisumu	False
Kwame_Raoul	True
Lame_duck_(politics)	False
Late-2000s_financial_crisis	False
Late-2000s_recession	False
Latin_honors	False
Laureate	False
Lawrence_Yates_Sherman	False
Lawyer	False
Leon_Panetta	True
Libertarian_Party_(United_States)	False
Library_of_Congress_Control_Number	False
Libya	False
Lilly_Ledbetter_Fair_Pay_Act_of_2009	False
Lincoln's_House_Divided_Speech	False
List_of_African-American_firsts	False
List_of_Democratic_Party_superdelegates,_2008	False
List_of_Presidents_of_the_United_States	False
List_of_Presidents_of_the_United_States_by_languages_spoken	False
List_of_United_States_Democratic_Party_presidential_tickets	False
List_of_United_States_Senators_from_Illinois	False
List_of_bills_sponsored_by_Barack_Obama_in_the_United_States_Senate	False
List_of_candidates_in_the_United_States_presidential_election,_2008	False
List_of_federal_judges_appointed_by_Barack_Obama	False
List_of_people_pardoned_by_Barack_Obama	False
List_of_places_named_after_Barack_Obama	False
List_of_presidential_trips_made_by_Barack_Obama	False
List_of_presidential_trips_made_by_Barack_Obama_during_2009	False
List_of_presidential_trips_made_by_Barack_Obama_during_2010	False
List_of_presidential_trips_made_by_Barack_Obama_during_2011	False
Liu_Xiaobo	True
Lolo_Soetoro	False
Los_Angeles	False
Luo_(Kenya_and_Tanzania)	False
Lyman_Trumbull	False
Lyndon_B._Johnson	False
Lynn_Sweet	True
Macondo_Prospect	False
Madelyn_Dunham	False
Mahmoud_Abbas	True
Malia_Obama	False
Manual_of_Style_(dates_and_numbers)	False
Margaret_Thatcher	True
Marian_Shields_Robinson	False
Mark_Kirk	True
Mark_Warner	True
Mars	False
Martin_Van_Buren	False
Martti_Ahtisaari	True
Mary_Ruwart	True
Matt_Gonzalez	True
Matthew_Shepard_and_James_Byrd,_Jr._Hate_Crimes_Prevention_Act	False
Maya_Soetoro-Ng	True
Mayor	False
Media_help	False
Menteng	False
Mexico_City_Policy	False
Michael_Bloomberg	True
Michael_Jingozian	True
Michele_Bachmann	True
Michele_Bachmann_presidential_campaign,_2012	False
Michelle_Obama	True
Mike_Gravel	True
Mike_Gravel_presidential_campaign,_2008	False
Mike_Huckabee	True
Mike_Huckabee_presidential_campaign,_2008	False
Millard_Fillmore	False
Mitt_Romney	True
Mitt_Romney_presidential_campaign,_2008	False
Mitt_Romney_presidential_campaign,_2012	False
Money_(magazine)	False
Moon	False
Msnbc.com	False
Muammar_Gaddafi	False
Multiracial	False
My_President	False
NASA	False
NATO	False
NNDB	False
NPR	False
NSA_warrantless_surveillance_controversy	False
Nancy_Pelosi	True
National_Association_for_Business_Economics	False
National_Association_of_Black_Journalists	False
National_Football_League	False
National_Journal	False
National_Public_Radio	False
Nationwide_opinion_polling_for_the_Democratic_Party_2008_presidential_candidates	False
Nationwide_opinion_polling_for_the_Republican_Party_2008_presidential_candidates	False
Nationwide_opinion_polling_for_the_Republican_Party_2012_presidential_primaries	False
Nationwide_opinion_polling_for_the_United_States_presidential_election,_2008	False
Nationwide_opinion_polling_for_the_United_States_presidential_election,_2012	False
Native_Americans_in_the_United_States	False
Nazi_concentration_camps	False
New_American_Independent_Party	False
New_Energy_for_America	False
New_START	False
New_York_City	False
New_York_Public_Interest_Research_Group	False
Newt_Gingrich	True
Newt_Gingrich_presidential_campaign,_2012	False
Nicolas_Sarkozy	True
Nicotine_replacement_therapy	False
Ninian_Edwards	False
Nobel_Peace_Prize	False
Northrop_Grumman_B-2_Spirit	False
Norway	False
Norwegian_Nobel_Committee	False
Nova_Publishers	False
Nunn–Lugar_Cooperative_Threat_Reduction	False
Nyang'oma_Kogelo	False
Nyanza_Province	False
Oath_of_office_of_the_President_of_the_United_States	False
Obama	False
Obama:_From_Promise_to_Power	False
Obama_(disambiguation)	False
Obama_Day	False
Obama_Doctrine	False
Obama_logo	False
Occidental_College	False
Of_Thee_I_Sing_(book)	False
Of_counsel	False
Ohrdruf_concentration_camp	False
Old_State_Capitol_State_Historic_Site_(Illinois)	False
On_The_Issues	False
Online_Computer_Library_Center	False
Open_Directory_Project	False
Operation_Neptune_Spear	False
Operation_Unified_Protector	False
Oprah_Winfrey's_endorsement_of_Barack_Obama	False
Orville_Hickman_Browning	False
Osama_bin_Laden	False
Oslo	False
Otis_F._Glenn	False
Oval_Office	False
Ovarian_cancer	False
Pakistan	False
Palestinian_National_Authority	False
Party_for_Socialism_and_Liberation	False
Patient_Protection_and_Affordable_Care_Act	False
Paul_Douglas	False
Paul_Simon_(politician)	False
Peace_and_Freedom_Party	False
Pell_Grant	False
Persondata	False
Personennamendatei	False
Peta_Lindsay	True
Peter_Fitzgerald_(politician)	True
Pittsburgh_Steelers	False
Political_positions_of_Barack_Obama	False
Political_positions_of_Bob_Barr	False
Political_positions_of_Cynthia_McKinney	False
Political_positions_of_Joe_Biden	False
Political_positions_of_John_McCain	False
Political_positions_of_Sarah_Palin	False
Political_science	False
Politico_(newspaper)	False
Portal/Images/Barack_obama	False
Portuguese_Water_Dog	False
Potomac_primary	False
Pre-existing_condition	False
Presidency_of_Barack_Obama	False
President-elect	False
President_of_France	False
President_of_Russia	False
President_of_the_Confederate_States_of_America	False
President_of_the_Palestinian_National_Authority	False
President_of_the_United_Nations_Security_Council	False
President_of_the_United_States	False
Presidential_Medal_of_Freedom	False
Presidential_transition_of_Barack_Obama	False
Prime_Minister_of_Israel	False
Prime_Minister_of_the_United_Kingdom	False
Professor	False
Prohibition_Party	False
Project_Vote	False
Project_Vote_Smart	False
Protection_policy	False
Protests_against_the_Iraq_War	False
Public-Private_Investment_Program_for_Legacy_Assets	False
PublicAffairs	False
Public_health_insurance_option	False
Public_image_of_Barack_Obama	False
Punahou_School	False
R._Lee_Wrights	True
Racial_profiling	False
Ralph_Nader	True
Ralph_Nader_presidential_campaign,_2008	False
Ralph_Tyler_Smith	False
Randall_Terry	True
Ray_McKinney	True
Reactions_to_the_death_of_Osama_bin_Laden	False
Reconciliation_(United_States_Congress)	False
Reform_Party_of_the_United_States_of_America	False
Relief_well	False
Republican_Leadership_Conference	False
Republican_Party_(United_States)	False
Republican_Party_(United_States)_presidential_candidates,_2008	False
Republican_Party_(United_States)_presidential_candidates,_2012	False
Republican_Party_(United_States)_presidential_debates,_2008	False
Republican_Party_(United_States)_presidential_debates,_2012	False
Republican_Party_(United_States)_presidential_primaries,_2008	False
Republican_Party_(United_States)_vice_presidential_candidates,_2008	False
Republican_Party_presidential_primaries,_2012	False
Republican_and_conservative_support_for_Barack_Obama_in_2008	False
Resignation_of_Shirley_Sherrod	False
Results_of_the_2008_Democratic_Party_presidential_primaries	False
Results_of_the_2008_Republican_Party_presidential_primaries	False
Reuters	False
Richard_J._Oglesby	False
Richard_Lugar	True
Richard_M._Young	False
Richard_Nixon	False
Richard_Yates_(19th_century_politician)	False
Rick_Perry	True
Rick_Perry_presidential_campaign,_2012	False
Rick_Santorum	True
Rick_Santorum_presidential_campaign,_2012	False
Riverdale,_Chicago	False
Robby_Wells	True
Robert_Burck	False
Robert_Gates	True
Rocky_Anderson	True
Roland_Burris	True
Ron_Paul	True
Ron_Paul_presidential_campaign,_2008	False
Ron_Paul_presidential_campaign,_2012	False
Ronald_Reagan	False
Rosa_Clemente	True
Roseanne_Barr	True
Roseland,_Chicago	False
Roy_Moore	True
Rudy_Giuliani	True
Rudy_Giuliani_presidential_campaign,_2008	False
Russia	False
Russian_language	False
Rutherford_B._Hayes	False
Róger_Calero	True
S-par/us-il-sen	False
S-par/us-sen	False
START_I	False
Sam_Brownback	True
Samuel_McRoberts	False
Sarah_Palin	True
Sasha_Obama	False
Scott_W._Lucas	False
Secure_America_and_Orderly_Immigration_Act	False
Security_Council	False
Sexual_orientation	False
Shelby_Moore_Cullom	False
Shimon_Peres	True
Sidley_Austin	False
Sidney_Breese	False
Sidwell_Friends_School	False
Siena_College	False
Siena_Research_Institute	False
Socialist_Party_USA	False
Socialist_Workers_Party_(United_States)	False
Sonia_Sotomayor	True
South_Shore,_Chicago	False
South_Side,_Chicago	False
Speaker_of_the_United_States_House_of_Representatives	False
Special_Forces_(United_States_Army)	False
Speeches_by_Barack_Obama	False
Spoken_articles	False
Springfield,_Illinois	False
Stanley_A._McChrystal	True
Stanley_Armour_Dunham	False
State_Children's_Health_Insurance_Program	False
State_Elementary_School_Menteng_01	False
Statewide_opinion_polling_for_the_Democratic_Party_presidential_primaries,_2008	False
Statewide_opinion_polling_for_the_Republican_Party_(United_States)_presidential_primaries,_2012	False
Statewide_opinion_polling_for_the_Republican_Party_presidential_primaries,_2008	False
Statewide_opinion_polling_for_the_United_States_presidential_election,_2008	False
Statewide_opinion_polling_for_the_United_States_presidential_election,_2012	False
Statute_of_limitations	False
Steeler_Nation	False
Stephen_A._Douglas	False
Steve_Kubby	True
Stewart_Alexander	True
Stewart_Greenleaf	True
Stimulus_(economic)	False
Stimulus_(economics)	False
Straw_polls_for_the_Republican_Party_presidential_primaries,_2012	False
Suharto	False
Super_Bowl_XLIII	False
Super_Tuesday,_2008	False
Super_Tuesday_II,_2008	False
Sí_Se_Puede_Cambiar	False
Tax_Relief,_Unemployment_Insurance_Reauthorization,_and_Job_Creation_Act_of_2010	False
Tax_credit	False
Tax_incentive	False
Tea_Party_protests	False
Ted_Weill	False
Terry_Jones_(pastor)	True
Thaddeus_McCotter	True
Thaddeus_McCotter_presidential_campaign,_2012	False
The_Audacity_of_Hope	False
The_Australian	False
The_Boston_Globe	False
The_Bridge:_The_Life_and_Rise_of_Barack_Obama	False
The_Case_Against_Barack_Obama	False
The_Christian_Science_Monitor	False
The_Daily_Telegraph	False
The_Detroit_News	False
The_Gallup_Organization	False
The_Guardian	False
The_Huffington_Post	False
The_New_York_Times	False
The_Obama_Nation	False
The_Obama_Story	False
The_Situation_Room_(photograph)	False
The_Speech:_Race_and_Barack_Obama's_"A_More_Perfect_Union"	False
The_Times_of_India	False
The_Washington_Post	False
Theodore_Roosevelt	False
There's_No_One_as_Irish_as_Barack_O'Bama	False
Third_party_(United_States)	False
Thomas_Jefferson	False
Three_Rivers_Press	False
Tim_Kaine	True
Tim_Pawlenty	True
Tim_Pawlenty_presidential_campaign,_2012	False
Time_Inc.	False
Time_Person_of_the_Year	False
Timeline_of_the_Presidency_of_Barack_Obama_(2009)	False
Timeline_of_the_Presidency_of_Barack_Obama_(2010)	False
Timeline_of_the_Presidency_of_Barack_Obama_(2011)	False
Times_Square	False
Timothy_Geithner	True
Tom_Carper	True
Tom_Coburn	True
Tom_Tancredo	True
Tom_Tancredo_presidential_campaign,_2008	False
Tom_Vilsack	True
Tom_Vilsack_presidential_campaign,_2008	False
Tomahawk_missile	False
Tommy_Thompson	True
Tommy_Thompson_presidential_campaign,_2008	False
Tony_Blair	True
Tony_Rezko	True
Toronto_Star	False
Tort_reform	False
Transition_to_the_New_Order	False
Trinity_United_Church_of_Christ	False
Truman_State_University	False
Turkey	False
Two-state_solution	False
Ulysses_S._Grant	False
United_Nations	False
United_Nations_Security_Council	False
United_Nations_Security_Council_Resolution_1973	False
United_Press_International	False
United_States_Armed_Forces	False
United_States_Congress	False
United_States_House_of_Representatives	False
United_States_House_of_Representatives_elections,_2008	False
United_States_House_of_Representatives_elections,_2010	False
United_States_House_of_Representatives_elections,_2012	False
United_States_Marine_Corps	False
United_States_Navy_SEALs	False
United_States_Secretary_of_State	False
United_States_Secretary_of_the_Interior	False
United_States_Senate	False
United_States_Senate_Committee_on_Environment_and_Public_Works	False
United_States_Senate_Committee_on_Foreign_Relations	False
United_States_Senate_Committee_on_Health,_Education,_Labor,_and_Pensions	False
United_States_Senate_Committee_on_Homeland_Security_and_Governmental_Affairs	False
United_States_Senate_Committee_on_Veterans'_Affairs	False
United_States_Senate_Foreign_Relations_Subcommittee_on_European_Affairs	False
United_States_Senate_career_of_Barack_Obama	False
United_States_Senate_election_in_Illinois,_2004	False
United_States_Senate_elections,_2008	False
United_States_Senate_elections,_2012	False
United_States_Senator	False
United_States_elections,_2008	False
United_States_elections,_2010	False
United_States_elections,_2012	False
United_States_general_elections,_2012	False
United_States_gubernatorial_elections,_2008	False
United_States_gubernatorial_elections,_2012	False
United_States_order_of_precedence	False
United_States_presidential_election,_2008_timeline	False
United_States_presidential_election,_2012_timeline	False
United_States_presidential_election_debates	False
United_States_presidential_election_debates,_2008	False
United_States_presidential_election_debates,_2012	False
United_States_presidential_eligibility_legislation	False
United_States_presidential_inauguration	False
United_States_third_party_and_independent_presidential_candidates,_2008	False
United_States_third_party_and_independent_presidential_candidates,_2012	False
Universal_health_care	False
University-preparatory_school	False
University_of_Chicago_Laboratory_Schools	False
University_of_Chicago_Law_School	False
University_of_Hawaiʻi_at_Mānoa	False
University_of_Nairobi	False
University_of_Southern_California	False
Use_mdy_dates_from_August_2010	False
Vague_or_ambiguous_time_from_November_2011	False
Vermin_Supreme	True
Vice_President_of_the_United_States	False
Virgil_Goode	True
Virginia_Governor	False
Virtual_International_Authority_File	False
Voice_of_America	False
Walter_Veltroni	True
War_in_Afghanistan_(2001–present)	False
Warren_G._Harding	False
Warren_Mosler	True
Wayne_Allyn_Root	True
We_Are_One:_The_Obama_Inaugural_Celebration_at_the_Lincoln_Memorial	False
We_Are_the_Ones	False
West_Pullman,_Chicago	False
West_Wing_Week	False
White_House	False
White_House_Easter_Egg_Roll	False
White_House_Situation_Room	False
Whitehouse.gov	False
Wichita,_Kansas	False
Wikimedia_sister_projects	False
Wikisource	False
Will.i.am	True
William_Alexander_Richardson	False
William_B._McKinley	False
William_E._Mason	False
William_H._Dieterich	False
William_Henry_Harrison	False
William_Howard_Taft	False
William_Lee_D._Ewing	False
William_Lorimer_(politician)	False
William_McKinley	False
Withdrawal_of_U.S._troops_from_Iraq	False
Woodrow_Wilson	False
Woods_Fund_of_Chicago	False
WorldCat	False
World_Trade_Center_site	False
Yes_We_Can	False
YouTube	False
Youngstown_State_University	False
Zachary_Taylor	False
